3
8 10
1 1 1 1 1 1 1 1 1 1
1 0 1 0 0 0 1 2 0 1
1 0 1 0 1 0 1 1 0 1
1 0 1 0 1 0 2 0 0 1
1 0 1 3 1 0 1 1 0 1
1 0 1 1 1 0 1 1 0 1
1 0 0 0 0 0 1 2 0 1
1 1 1 1 1 1 1 1 1 1
8 10
1 1 1 1 1 1 1 1 1 1
1 0 1 3 0 0 1 2 0 1
1 0 1 0 1 0 1 1 0 1
1 0 1 0 1 0 0 0 0 1
1 0 1 0 1 0 1 1 0 1
1 0 1 1 1 0 1 1 0 1
1 0 0 0 0 0 1 3 0 1
1 1 1 1 1 1 1 1 1 1
14 9
1 1 1 1 1 1 1 1 1
1 0 1 0 0 0 1 2 1
1 0 1 2 1 0 1 0 1
1 0 1 0 1 0 0 0 1
1 0 1 0 1 0 1 0 1
1 0 1 1 1 0 1 0 1
1 0 0 0 0 0 1 0 1
1 0 1 0 1 1 1 0 1
1 0 1 0 1 2 1 0 1
1 0 1 0 0 0 1 0 1
1 0 1 1 1 1 1 0 1
1 0 1 3 1 2 1 0 1
1 0 1 0 0 0 0 0 1
1 1 1 1 1 1 1 1 1
